no_disulfide_b4inin	TCTCTGGAGGAACTGATCGAAAAAATTGAAAAATTTAACAACCTCGAGAATCCTACCGAGGAAGAGCTGGAGGAGCTCATTGAGCTCTTAAAAGAATGGTGTGAGGAACTTGGTGTAGAAGAAGAGAAGAAAGAGGAGCTGTTAGAACTGCTCTACGAGTGGTATAATAGCGAAGAAAATCGCGAAGAGAAGACAAAGGAGCTCATCGAAAAGCTCAAGGAAGTTTACGAGGAGGCG
no_disulfide_b4innn	CCTCTTGATCCAGAGGCCGTTCGCGCTTGGTTACGCCGTGCTTTGGCAGAACTCCAGGCCGAAGGTCTTGCAACACCTGCACTCGTGGCTGCAGTAGAAGCCCACGCAGACGAGATCGCCGGTGCGGACGCTGAAGGGGCCGCGGCGCTGCTCCGCCGTCTGTGTGCAGAGGTCGGTGCTTCACCAGAACTTACAGAGCGGCTGCTGGCTCTTTGGGAGGAGTTCGTAGCATCACAG
no_disulfide_l5innn	GAGGAGTTGAAAGAGAAACAAGAGGAACTCAAGAAGAAAGTAGACAGCGAAGAGGTGCGCGAACTCTGGCTCGAAGCGCTTAAAAAAAAAGGGGCTGATGAAGAAGAAGCCCGTAAAGTGATCGAGGAGGCTGCCGAGCGTTTGAAAAAAGGTGAGAGCATGGATGAGGTCCTCGAATGGGTTAATAAACGCCTGGGCAACGGGTTGAACAAGGAGGATCTTTTAGAACTTTTGGAAAAG
no_disulfide_b4nnnnx	TGGGAGGAGTTGGAGGAGGCTGTCCGTTGGCTCCGGGAGCGCCTTCCAGACCTGACCGAAGAGCAGCACATCGAGTATATTCGGCGGTATGCTGAGGAAGGGCCGGATGATTTATCGCCTGAAGTCCGTGAGGCTCTGGAAGAGCTTCGGCCTTTGATTGAACGCTATGGCGAAGAAGAAGTCATCGAGGCCCTGCGGCGGTATTATCGGGAA
no_disulfide_b4nnnny	ATGAGCCGGGAGGAAAAAATTAAACTTCTGAAGGAGAAGGGCTATAATCTTTCGCGCGAGGAACTCATTAAACTCATTCTGGAAGAATATGGCTACGATACCGAAGAGACTAAGGAGTTGCGGGAAAAGGCGTACGAGGAATTGAAGAAACTGGATTGGAATCTCTCCCGGGAGGAGCTGATCGAGCAAATGGTAGAAGTCATCGACAGTTTA
no_disulfide_l4iin	ATGGAAAAGCTTGAGGAAACCGCAAAGAAATTGTATGACATTCTTTCTAACGACGAGGAGAAGTCTGAGCCAATTGCGGAGAAGATTCGGGAGAAGACAGGGCTTAACTGGTCGAAAGAGGAAATCCTTGAATTGATCGAGGATTACCTTGAGGGTAAGGCCAAGGAGCGTCGGGAGGAGATCGAGAAGATTTGCAAGGTTTACGAAGAACTT
no_disulfide_b4iiin	TCACGGTATGCCGAGGCTTTGGAGCTGATCCGGGCCAAACTCCCGGATACGCCGGAAGGGCGGGAACTCCTCGCGGCCTTGGAGGCAGGCACATTCGATCCAGAGTGGGCCATCGCATGGTTACGGGAGGCAGGTTTCTCTGAGGAAGAATTGGCGTATCTGGTGGGGGTGCTCGAAGAGGCAGCAGGT
no_disulfide_b5iinin	AGCCGGGAAGAGTTATTGGAACTCGCGAAGAAACTGCTTGAAGCGATCAAATCTGAGGAATTGAAAGAAGAATGGAAGGAGCTGCTTGAAGAAATCCTTGAAAACGGTTTGAATGAGGAACTGCTGAAGCGGTGGGAGGAGTGGCTGGAGAAGCTGGAGAAGGAGGGGCTCTCGGAGGAGGAGAAGGAGCGCTTAATTGAAGCACTGCGTGAACTGCAAGAATGGTGGAAAGATCCATCAAAGCGTGAAGAACTGCGCGAACTGTTGGAAGAGATCCTGTCGCTCATT
no_disulfide_b5iiiin	ATGGACCTCGACAAGGGTTTGGAAGAGCTTATTGAACGTATTAAAAAAGGCGAGGCGCTCGAAGAACTGAAGAAATTCGGGAAGGAAGCGAAAAACCTCCCTAAGGAGGTGAAGGAAATCCTTGAGAAGTTGGAAAAAGGCGAAGCGACAATCGAGGAGGTAGTCGAGATGTGGGAAAAGCTCAAGAAAAACTACAAGGAGTGGGGGATCGAGGAACAATTGGAGAAATTACTCAAGTCC
no_disulfide_b5innnn	TCTGCTGAACTGCGGGCGCTTGCTGAAGAGCTTCTTGCTCGCCTCGCTGATCTCCCGCCAGAGGACCTCGCGGCTTTAGTCGAATATCTCTACGCCCGGGAAGGCTGCGGCAGTCGGGAAGCAGTGCACGCCGCCATCCGTGAAGCTGCTGCTGCTGGGTTGGACCGGGATGTGGAAGCAGTCCTCGCAGCCTGGGATGAAGTTTATTCGCGTCTGGGGCCGGACGCAGAAGCGCAAATGCGGGAATTGTTGGCACTTCTCGCCTCACGT
no_disulfide_b3nnn	TCGGACGAGGAGTTATTAGCTGCCGCGCGTGCCTGGTATGCAGAACGGGGGCTGGGGCCAGTTCCTGAAGCAGAATTGCGGGCAGATGCTGAGCGTGTAGCACGCGACATCGCGGGCGCCGCTGATCGGGAAGCCGCATTGCGTGCAGGTTTTGATCGGTGGTTGGCCGCCCGG
no_disulfide_b3iii	AAAAAGGAGGAAATTCGCCGTTATCTCCGCGAGGTTCGCCGCCGCTTGGAAGCGGGCGAACCTCTCAGCGAGGAACAGCTCCGGGCTATCGAAGAGGCGCGTGAATGGCTTGAGGAAAATCGTGAGGAGTATCCTGAGGAATATGAAATTGTCGAGGAAGCCCTGAAGTCATTG
no_disulfide_l5niin	ATGGAAGCCTTGTTAGCTACCGTCCGTGAGCTGGGTCTTACCACGGTTGGGGACGGTCTGGAGGTCTTTACGGCACGCTTGGATTCCCTCGCACCGCGCCTTTCGCCTGAAGAGGTTGAGGAATGGCGCGAAATGGTTCGTCGCTTAGTAGCGTCCGCCGCAGATCCTTCAACCACTACGTGGGCTGAGCTTGTGCGGGCCCTTGCTGCTAGCGATGACGAAGAGTTACGTGCTCGCTGGGAGGAAGCAGTACGTCGGCTTGCCGCTGCA
no_disulfide_l4inn	GACGAACTGGAAGAAGGGATCCGTTATCTGTACGAGAAGTGGAAGGAAGAGAAGGGGCTGAAATCTCAAGAGGAACTTTTAGAATTACTCCTGGACGAGTCGAATGCTGAAACGGAAGAGGAGAAGGAGATCTATAAGTTGATCAAAGAGTACAAGAAGAAGGGTATGACGGACAAGGATTTATATGAAATTCTGTCGAAAGTTGAAGAGGAG
no_disulfide_b5ininn	ATCAAGGAGCTCGTCTACAAAACGATTGAAAAACTGCTGGAGAATATCGATAAGAAAGAGACTGCAGAGAAGTGGAAGGAATATATTAAGTGGCTTGAAGAGAAAGGCTTGTCCAAGGAAATTCGTGACGAGTGGATTAAGTTAATCGAGGAAATGGAAAAAGGGATGGACAAGGAAGAGGCAAAGAAACGGGCCTATGAGTTGGCCGACAAGGCCCTCGAAGATCTGCTTAAGAAGCATTCCAAGGAGGAAGTTGAGGAACTTATTCGCGAAGTTGAGTCAAAATTG
no_disulfide_l5inni	ATGGACCGTTTAATGGCAATCTTTGCCCGGCTGCCGGAAATCCTGCGGGAGGCTGGGGACGAAGAGTTACTCGGGCTTTATCAGTGGTCGCAAACAGCTAGCTACGAAGAGGCCCTGGCGCGGTGGCTGGCAGCAGTGGACCGTCTGTTGGCACACCCTGAGCGGTACGCCGGTACTGAACTCGGTGCAGCGATTCGTGAGCTGAAAACATTACCAGAGGCTGAGGCTCGTGAGTTGCTCCGCAACGCCGTGGCAGAGTGGCTGAAATCC
no_disulfide_h5n_n	ATGAGCACCTCGGAGCTGTATGCCATTCTGTTTGGCGGGATTACGCCTGCCGAAGTTTATGCAATGTTCCGCGAAGTGCGGCCAGGTATGACCCGCGCAGAACTCAACGCCCTGTGGAACGAAGTCCGTGAGAAATACTCCTCTTTAAGCGGCGAAGAAATTGTGGAGGAACTGCGCAAGAAATATCCTGGGTCACCTTTAGAGATGCTCCGCAAATTGTACGAAGAT
no_disulfide_b4iiiix	GGTGAGTGGGTTGAGCGGTACCGCGAGTTGTTGGAGTATGCAGTAGAATACCTTGGCGAGCCGCGCTACGAAGAGCTTCGTGAGACTTGTATCCGGTTGGGTGGCATCGACCCAAGTCTGTCTGAAGAGGAACTCCGCGAGCGCATCCGTGAATTATTGGAGCGCTCTATTCCGCGTGTAGCGGCGGGTGAAGAACCAGAACTCCGCGCGGTATTAGAACGCTTGCTTGCGGAACGC
no_disulfide_b4iiiiy	AGCCTGGAAGAATTTAAGGAATATGTGAAAAAGCAGACCGACTTGGATAGTCCTCTTTTGCCGTGGATTCAGAAATGGTGCGAAGATCCGTCCGACGAGGAGTACACGGCGGAATTGCGCGAGAAGCTCGCAAAGGCCGACGATAGCTATCCTGAGTTGACCGCGTGGGCGCGCAAGTATTGCGACTCA
no_disulfide_h4i_n	ATGGAAGAAGAGGAACAATTTAAGAATCGCTGGCGCGAGATTCGTGAGGAAGTGTATTCAAAAGGCGGCGGTGACGAGGATACTCTGCGCCGCTTGCGGGAACTGGAGAAGGAACCTCGCAGTGAGGAAGAAGCCTTTCTGTGTGAGCGCTACCGCGAACTCCGTGCTGAATACTATGCAAAGGGTGGGGGCGATGAAGATGTCCTGCGTTACATTAAAGAGTCTTTG
no_disulfide_l5iiin	TCAGAGTTGAAGGAAAAACTCAAATATCTGCTTGAACATCCGGAAGAGTTGTCGAGTGAGCGGTTAAAAGAGATGATTGAGAAGCTCAAAGCTGGGTTCTACGGTTATTGGGAGGAGTTGCGTAAGGTTCTTGAAGAGCTGGCTGCCGACGAAAGCGCTACATCACCATACGAGCTTGCTTTAATTGAGTTTTATGAGTTGTCCAAGGAATTATCCGAGGAGGAGATTGAGGAACTGATTAAAGAGGTGCTGGAGGAG
no_disulfide_b6iiniin	TCCGAGGAACTCAAAAAATATGCAGAACGGGTAGCGAAGGCGCTTGCCGAGGGGAAGCTCGAGGGTTATTTGAAACTGGTAGAGGAATGGTCCAAAGTAGACAAACCTTTTTCCAAGGAGAACTTCAAAGAGATGCTGGAGAAGGCGCTTTCTACGGAGGAAGCAAAAGAGGATAAAGAACTCAAGGAGGCCCTGGAGTATATCCTCGAAAATCTGGACGAATGGTCCTTAGATGAGATTAAAGAGTACCTGGAATATGCGCTCAAACTGGCGAAGGAATACGGGGTGGAAGAGTACACAAAGTATTTGGAAAAGTTATTATCAAAA
no_disulfide_h5i_i	CTCACGGAAGCAGAACTGCGGGCACTCTGCGCCGGGCGGCCACCAAGCCCTCGGGTCTTAGCTTTGTGGGAGGGTGTTTTACGCGGCGAAACGCTCGAATATGTGCGTCCTGGGTTTGAACGCGCCGAAGCTGGCGAATTATCCCCGGAACTCCGTGCTGGGTGGGAACGGCTTTTGGCTCGTGCAGAAGACCCTCTCTTAGGTCGTGTACTGGACTTGCTGCGTGGT
no_disulfide_b6ininin	ATGGAACTCGTATATGAATATGTAGAGAAGTTACTTTCGCTTTCGCATGAAGAACGCCGCGAATACTTATATAAAGAAGCACAGAAAGCATCCGAGGAACTGGGCTACCCTCCAGTAGAGACACTCTACGAGTGGTGGGATTACCTTTTGAAGAACCTGAGTGAAGAGTTAAAGGAACGTGTCCATGCTTTTGTAGAGGCCTTGTGGAACGGCGACGAGGAAACCACTCGCGCAACGGCTTTTCCTGTTTGGGAGGAAATCCTTGAGGCCCTGAGCGAAGAAGAACGGGAGAAACTTCTGGAACTGGTAAAAAAGTGGTATGCGGAA
no_disulfide_l6niiin	AGCAGTTTACTGGAGGAACTCTATCAACAGCTGTACGATGCGGGTATCCTCTCAACGCCAGAGGCACAGGAAATGTTGCGTCGTATTTTGAACCCTGAAGAAGCCTCCATTGAGGAAACTTACGAGTGGTATAAGTGGGCGTTAGCGAACCTGCCGGAAGAACAGGAGCTGACGCGGGAGCTCTATGAAGAAGCACTGGAGCTGCTTGAGAGCGGCGTCACTTCACTTTATGACATTTATAAATATGTGGGCGATAAACTCGGGCTCTCTTTAGAAGAGTTTTACGAAGCAATCAAGAAGGTGGTAGAGCGT
no_disulfide_h6i_i_i	GGTAAAGAATTAGCACTGGAGACGTTTTACAAGCTGTACGCCGGGGAGTGGAAAACGGAGGAGCAGAAGAAGATCCAGGAGGTGTGGAAGAAACTGTGGGAATTGGTCGGCAAACCGTTTTCGGAGGAGGGCATCATCGAGGGGTATCGCCTGCTGCTCGAAAAATTAAAGGAAAAAGGTGCGTCTAAGGAATTGATCGAGTACGTGGAAAACTTAATTAAAGGTTTGGAAACTGGCGAGTTGAGCGAGGAAGTACTGAAATATATCGAGGGGCTGAAAAACCCTGAGGAGAATAAGGAAGTATTGGAGAAGATCATGAAAATGTGGGAAGAGATTGAAGAATGCCTG
no_disulfide_b6inninn	ATGAGTATGCACGAAATCATCGACTCGATGGATGTCTCTCCAGAAGTCCGTGCTCTGCTTCGTGAATGGTGGGATCGTATGCTGGCTCGGCGTGAAGATGTGGATGCGTGGCTCGCTATGGTACGTTCTTGGGGGCTGTCAGAACACCTGTTGCCTCTCTATGAGGAATGGGTCCGCAAGGTTTTCGACGGTACCGCGACGACGGAAGAAACGCTTGAAATGTGGCGGCGTTGGTTCGCCGAACATGATGCAGAAGAGGAAGTACGTGCTTGGGTTGAGCGGTGGATGGCT
no_disulfide_l6innni	TCCCTCTATGAAGAGTTTATGGAATACTTAATGAAAGAAAATGACCTCGAAAAGTTAAAAGAACTTGCGAAAAAGATCGCCGAGAAAATCGGCGCTAAAGATTATATCCCGTTAGTCGAGGAAAGTCTTGAATACCTCAAGGAAGGGAAATGGGAGGAGATGCTTGAGTATATGTTATCGAAGTTGCCGAAGACGAAGCTGCGCGAGGAGTTAGAGGAAATCCTCGAGGGCAAGCTGAGCCCGGAAACAGAGGAGCTGATTAAAGAATGCTATTCA
no_disulfide_h6n_n_n	ATGGAAGAATTAAAGGCGATGTATGAAGAACTCATCAAAAAATACGGTGTAAAAGATAAGGAGGGCCTGTTAAAAATGTTTGAGAAGCTCCGGGAGGATGTGGAACGCGGTGAGGACACACCTGTCATGCGGGCATTCCGTTGGCTTTTAGAGAATCTCGAAGAGATCCGCGAGAATGGTTGGATCTGGGGTTATGCGCGTATTCTGGGTCTGCCTTTAGAAGAGGCTAAGGAAGTAAGTAAGGAGCTTGCGCTCTGGCTCCTTAAACAGATTGGGTGTGAGTCATATGAGGAGTGGTTAGAAATTGTTGAAGAATTTCTCAATAGT
no_disulfide_s6	AGCATGGTAAATCAGTACTGGCGGGATGCACTGGCAGGGAAACGGACGCCGGAGCTGGAAAAATGGTGGGATGAAATTGCCGAGAAATATAAGGGTAAGACTATCGCCGAAATTTGGAAGGCGTTACAGGCGGGTGAAGGTTCCGAAGAGGTAAATGCGTGGTGGAAGGAAGCCCTCGCAGGCAAATTAGATCCTGAAATTGCGAAATATGTTAAAGACGCACAAGCAGGGAAATTCAGTCCTGAGTTCGAGGCGGTTTGGAAACGGCTGTTCAAG
variable_linkers_b4inin	GTTGAGGAGTGCTTAAAGAAGTGCAAATCAGGCAACAAAGAAGCTATCCCAGAGTGCGAAAAAGAGTGGAAAGCTAAAGGTGTCAAAAACGCTGAAGAGTGTGCAAAGAAGTGGAAGGAAGGGAACTGTGAGGAGTGTGCCAAGAAGGTCAAGTCT
variable_linkers_l5innn	ATGAAGAAGAAGGTCGCAAAGCAGCTCGAGGAAGGCAAGGTCGACCCGGAATTACTTGCCAAGGTCTATAAAGAGCTGACAGGCGATGAGTCGACGGCCAAAATTGTCGCTAAAGTGGCAAAAAAGAAATTGAGTAAGGAGGAATTAGCTAAGGAAATGAAAAAGGAAGGTGTGACCATCTCCGCTAAAGCTCTCGAGAAGTTA
variable_linkers_b5ininn	GCTATCGCGGACCTCACAAAAGCAGTTGCAGCAGAGGCAGCAAAAGCGAAGGATGCTCGTTTAAAAGCCATTGCCGAGGCATTAGCGAAGGCCAAAAACGTCGACGAGGTCGAGGCAGTGCTGAAGGCTGCTGGGGCGGATGCAGACGCCGCAGCCGCCGCACTGCGTGCAGGGAACTGGAATGCAGCCACTATTGCCAAAATTGTAGCAGATATTGCA
variable_linkers_b6ininin	GCCGAGGAAATCAAAAAGGCACTTAAAGAAGGTGAAGCTGAAGAGATCGCTAAAGCCCTGGCAAAACTGGGGGCTAACGCTGAGAAGATTAAGAAAGAACTCGCGAAGGAAGGTCCTGACTATGACGCTATTGCGGAGGAATTAGCCAAAATCGGGAACGCGAAGCTGGCCCCGGCTATCAAGAAGGCGCTGAAAGAGGGCGAAGCTGAGGAAATTGCAAAAGCACTTGCAGAG
variable_linkers_l6innni	GGGGAAGAAGCCCTCGAAGCTCTCCGGCGGGGCGAGGTCGAGCCTTTGGTTGAGCTTTTACGTGCTGCCGGGTTGGAAGAGGAGAAAGCGGAAGCCATTGGGGAGGCCCTTGCTGAAACTGAGTCATTGGAAGAAGCCGCAGAAGCTCTCTCCGAATTCGGGGATGGGGAACGGGTGCGGGAAGCGTGGCGTCGGGGGGAGTGGGAGGAAGCCGCACGTTTGTTACGGGAA
variable_linkers_h5i_i	AAAGCCGCAGAGTGGATGAAGAAGGTGGCTAAATATTGTAAGAATTTGGACGATCCTGAACTCAAAGCGGCAGTTGAAGCCGCTGCGAAGGGCGATAAGGAGGTTGCGGAAAAGTTAGCTTCACTGAAAGGCAAGGGCGAAGAGGTGAAAAAATGGTTGGAGAACCCGGAAAAAGATCCAGAAAAGCAAGCAGAGAATTGTCGTTTACTGAATGAAGCTCTTAAATCT
variable_linkers_l4inn	CGGGAACTTATCGTGGAAGCAGCACGTACTGGCGAACTTGAAGAAGCGCGTGAAGCAGTAGAACGGGCCGGGCTCTCACGGGAAGAAATCCGTGAAATTCTGCGTGAAGCTGGCTTTGAGGAGGAAGCCGAGGAGTGGGTCGAGCGGCTG
variable_linkers_b3nnn	CTCGAAGAGGCAATTTTGGCCGCGATCAAGGAGGCCGGGGCAGAGGGCGAGGATTTAGAAGAGCTGCTGGCTCGCGGCCGTGCGGCTATCGAAGCCAATCAGCGGCCTGATATGAATGAGGAGTGGATTCGTGCTGCTGTGGCAGCAGCGTTAGCG
variable_linkers_b6iiniin	ATGCAAGCGCTGATTGAGGCATTCAAAGCAGTAGAGACTAACGCTGAACTGCAGAAGGTTGTAAAAGACTTGGAAGCGGGTAACTACGCAAATATCGCTGCCGCCTTCGAGGCCGCTGGCCTCTCAGCCGCTGACGCTGCCAAACTTGCGGCGGACTTAAAAGCAGGTGAGGTAGCTCCGATCGTAGAACTCTTAGCGAAGATTGATAGTCCTGAGTTTGCTCCTGTAGTAGAAGCAGCCAAGGCC
variable_linkers_b4nnnnx	GACATTGAAGAGAAGTGCAACGAACTTCTGGAGAAATCGAAGGGGGCTAGTTTAGAAGAGAAGATTAAACTGTGCAAGGAGTTCGGGAACGAAGAATCGATTGAAAAATGCTTGGAGCTGCTGGACAAATACGAAAAAGGTGAGTTGACAGAGGAAGAGAAGAAGGAAGCGTGCAAAGAGCTGGCA
variable_linkers_b5iinin	GAAGAGGTATTAGAGGTACTCAAGAAACTTGGCGGGGCGGAAGAGGCATACGAAGAACTTAAAAAAGACGACAAGGGCGCGATTGAGAAAGCAACCAAGAAGGTTGAAGGCCCAGAGAATAAAGAAGTCGCGGAACTGTTGAAAACCGCAAAGAACAAAGAGGACTTCGAAAAAGTCTTAAAGAAGGCA
variable_linkers_l5inni	ATGAAAGAAAAATACGCGAAACTCCTCGAGGAGGTGGCTAAAGAGACCAATGAGGTTATGAAGGAAATTGCCGAAATGCTGAAGAACGTGGACGAAGAAAACCCTCTGGAGGATCTCAAAAAGAAGATCATGGAGAAGTTCGGCGCATCGGAAGAGGTTGCCGAAGAGTTTGCAAAGGCCCTTAAGGCTGGTGACAAAGAAAAGTTGAAGAAATGCGTTAAAAAGATCCTTGAA
variable_linkers_b4iiin	GAGCGTCGTGAACGGGTGATTGAACGTTTACGGGAGTATGCTGAACGCTTTGAAGGCACCCCGTTGGCTGAAGAGATTCGCCGCGTGGCTGAGCGTTTGGAGGCTGGTGAGAGTGACCTGGAAGGCTTACGTCGGGTATTTGAAGCTGCTGGTGATGAAGAGTGGCTCCCATTAGGTGAGGAGGTAGCGGAAGAG
variable_linkers_b6inninn	TATGAGGAGTTAAAGAAAAAGTTAGAAGAAGTGACGGGGAACAAGGAAGGGGCCGAAGAACTCGCCGAAAATCTCAAAAAAGGTAACACCGAAAAAACCAAGGAAATTTTGCGGGAAATGGGGCTGGGTGAGGAAGCGGAGCTGATTGCAGAGGCGCTTAAAGGTGAGAGCTTAGAGGAGATTAAAAAGGCTCTGGCTTCGCTTGCACCGAAGATGAAGTCCGAAAAGGAGAAGAACGTCATTAAAGCCGTGGAGGAG
variable_linkers_l4iin	CTTGAGGAAGCGTTAAAGGAGTTAGATGGCGAGGGTGAAGCGGCGGAGTTGGCACGGGAGGCACGCGAGAAGTGCAAGGAGGATGAAGAATTTCGTAAAGAGTTAGAAAAAAAACTGAAGGGCTACAGCAAGGAAAAGGCTGTGGAAGTCCTGAAAGAG
variable_linkers_l6niiin	ATGGAGAAAATTTTCGCGGCCCTGAAAGAAGCCTCCAAAAAAAAGAGTGGCAAAGCTATCGTTGAGGCACTTAAGAAAGTGGCTGCGGAAGTGGACCTCAGTCCTGAGGAAAAAGAAGCCGTCGAAAACATCGAGACCGGCTCAGACGCGGAAAAGATTAGTGAAATCTTTGCAAAATGGAAGGAGAAAGCGACAGATCCGGAGGCCAAAGAAATCCTGGATAAGGTGTCAGAAAATTTAAGTTTTGAGGGGCTTGTTGAGGCCCTTATTAAA
variable_linkers_l5iiin	AAGTTAGAGGAGGTAGCAAAACTCTTAGACATCAATAATACTGAAGAGGGGAAGAAGGCGTTGGAAGCATTGAAAAAAAAGGAGGATTATGAGCTCTTAAAGAAGTACGTCGAGTCCCTTCCTGAAGACCTTAGTGAGAAGGACAAGGAGTTGCTGGAAAAATTCAAAGAGGCCGCCAAGAAGGCCACTACGATCGAAGAGTTGGAAAAACTCCTGGAAGAG
variable_linkers_h4i_n	ATGAAGCTCCTGGAGGAATTAGAGAAAATCTATAAAGAAGACAAAACGCCGAAGGATGAGAAGACGTCGCGTCTGATTGAAAAGGCACTCAAGTGCAAGGAAGGCAAAGACTGTGAGGAACTGAAAGAAGCTGAAAAATTGGGGAACTTCGAAGACGCACTCAAATACGCCGAAGAA
variable_linkers_h6n_n_n	ATGGAAGAATTTGCGAAAGTCCTGTTGAGCGGTTCGGGTGAAGAGATTCTGAAAGGTATCGACGAAGTGCTGAAGGAGCCAAATGGGTACGAGAAATTGGAGGAAGCCTTAAAGAAATTGGGCGTGGAAAACGCTGAGGAAATTGCTGAGGCTCTTCGTACGGGCGAGGGCTTCGAGGAAATCGCCAAAGCACTGAAAAAGGCTAAGAGTGGTGAAGAAATTGCAGAGCTGTTAAAAAAG
variable_linkers_b4iiiiy	ATGGAAGAGGCTTTGAAGAAGGCGGAGGAGCTTTGGGAAAAGACCAAGGATGAGAAGATGCAGACCCTTCTTGAGGCAGTCAAGAAAGGGGGTGATAAAGAACTCCTCGCTAAATCCCTCAAAACTGGCGAAATGGAAGAAGCATTGAAAGCTGCGAAAGCG
variable_linkers_b4nnnny	ATGGAAGAAATCCGCAAGCGGCTGGAGGAGGGCGGGTTAGAGTACGCAGTAGAGGTAGCGAAGGAATTTGGTGACATTGAAAAAACCGTGAAGGCCGCTGAAGAATTAGGTTATGATCCGGAGGAACTTCGCAAATTACTTGAGGAG
variable_linkers_l5niin	GTAGACGAGTATTGCGCTGCGCTCCGCAAGGCGGGGTCCGAAGAGGCGTGTGAGGCTCTCCGCAAAGTAGCCGAGGGCACGGGCGATTTCGAGGAGTTTAAAGCGTTATGCGCCAGTATTCCTGAAGACAAGTTTGACGGGCCTCTTGCCGAACTGAAGGCGATTTGTGCGTCTGCCTCAGGTGACGGCCTCGCGAAGCTCCGTGAACTGCTGGCA
variable_linkers_b5innnn	AAAGTGGAAGAATTGGCGAAAGCTATGAAGGGTGTGAGTACAGAGGAATTGTTAGAAGTCCTGAAGGAAGCCGGTGTACCAGAGGAGGACGCTGAAAAGCTGTACGAACTGGCCAAAAAAGGGGGTGAGGAGGACTTCAAGAAAGCAGCAAAGGAGTTAAAGGAGGAAGGGGTAGAGAGTTTAAAGCCGGTTTATGAAGCCGCCGAGAAG
variable_linkers_b3iii	ATGGAAGAGAAAGCGAAAGAGATCGTTGAACTGTATAAGGCGGGGAAGCTCACGGAGGAGCAGAAGAAAATTGCGAAGGAAATCCTCGAGATCGAGAAAAAGGAAAAGAAATTTTCTGAGGAGTTGGCTAAGAAGGTGGAAGAAGTCGTAAAA
variable_linkers_h6i_i_i	ATGGAGGAATTACGCGCACACATGGCAGAATGTTTAGAGATTGCCCGTGAACGCGGCAACGAGCGGGCCGCCCGCGTCTGTGAGGCGATTCTCAATGCAAATACGGCGGAACATGAGAAGATGGCAGCAGCTCTGGAAACTGGTGAGGACATGGACGGTTTGGCAGCGATTCTCAGTAAAGCTGGCGGTATTACGCCAGAGTTATTCCGTGCGCTGATGGCAGAATTGCTGGCAGAACTTGAAGCGCGGGGCCGGGCGAAGGATTTCCGCGCTTACGCTGCCCGGATTGCGGCC
variable_linkers_h5n_n	ATGGAGCTTTTTAAGAAGGCCATCAAGCGGGCAAAAGAGCTTGGGGTTAAGAATGCTGAGGATCTGAAAGCCGAATTGGAAAAGTATGGTGCCTTTGAAGAAGCAGTGGCGGCCCTCAAAGCCGAGGTCGATAAAGAGGGCGAAAAGAGTAAGGAGGAGCGTATTGAGATCGCAACCAAATTAGTCACTGAAGAAGAGGATGAGTTGACACGTAAGATCGTCGCAGAGATGCTC
variable_linkers_s6	GGCAAGGAGTTCTGTGAAGCCTTGAAAAACAAAAACAGCGAGAAGCTGAAGCCTTACGCAGAAGCTCTCAAGAACGGTGATCCTGAGCTTCTTGCTAAATTTGTCGCGGCCTTAAAGGCCGGGACTTGCCCAGAATTTAGCGCTGAGTTGGCAGGTGCAAAGAAAGGCAAGGTAAGCGAGAAAGGGAAAGAATACGCCGAAGTATTTAAGGAGAAAAGCGGCATCTCCCGCGAAGAGTTAGTTGCGAAAATCGCGGCC
variable_linkers_b4iiiix	GATATTCTCAAAAAGGCTGCCGAATTGTGGGCCTCATCAGACGACGAACTCATGAAGAAAGTCGTGGACGCTGTGTTGGCAGGCGATTTGAGCTCTCTGAAGCCGGAGGAACTTGAGGCAGCAAAGAAGAAGGCGCTTGAACTTGCGCCGGAATTTCCTGAGGAGGATCGTCCTATTGTGATTGAAGCCGTAAAACTCATC
variable_linkers_b4innn	TCGCGGCTTGAAGAGATTTGCTCGAAGTTATCTGGTCCAACTGCGGCCAAAGTTTGTGAAGAATGTAAAGGGTTGTCATTGGACGAATGCTGTGAGCTTGGGTTGAAGTACGGCTTACCGGAGGCGTGCGAACTGGCACGTAAA
variable_linkers_b5iiiin	GAACGCGAGAAAGGGATTGAATACTTGAAAACATTAAGTAGCCCAGTCTCTGATAAGTGTACTGAGGACTTTGCTGCGGGTAAGCCTAACCTCAAAGCGTGCTTAGCCGCCTTAAAGACATCAGGGGCCGAAATGAAGGCCATTGCAGATAAGTGCGAGACCTTGGGGGCCAACGGCTGGGACGAATGCTTAAAATTGGCCTTG
